"filename", "language", "HTML", "JavaScript", "CSS", "comment", "blank", "total"
"c:\vs code\GitHub\internship\Center National des Innovations Pédagogiques et d'Expérimentation (CNIPE)\2024\dev\front-end\EspaceFormation.html", "HTML", 9, 0, 0, -23, 4, -10
"c:\vs code\GitHub\internship\Center National des Innovations Pédagogiques et d'Expérimentation (CNIPE)\2024\dev\front-end\aide.html", "HTML", 15, 0, 0, 0, -3, 12
"c:\vs code\GitHub\internship\Center National des Innovations Pédagogiques et d'Expérimentation (CNIPE)\2024\dev\front-end\course.html", "HTML", -96, 0, 0, 0, -1, -97
"c:\vs code\GitHub\internship\Center National des Innovations Pédagogiques et d'Expérimentation (CNIPE)\2024\dev\front-end\courseContent.html", "HTML", -51, 0, 0, -103, 6, -148
"c:\vs code\GitHub\internship\Center National des Innovations Pédagogiques et d'Expérimentation (CNIPE)\2024\dev\front-end\css\course.css", "CSS", 0, 0, 9, 0, 3, 12
"c:\vs code\GitHub\internship\Center National des Innovations Pédagogiques et d'Expérimentation (CNIPE)\2024\dev\front-end\css\courseContent.css", "CSS", 0, 0, 272, 0, 126, 398
"c:\vs code\GitHub\internship\Center National des Innovations Pédagogiques et d'Expérimentation (CNIPE)\2024\dev\front-end\css\domain.css", "CSS", 0, 0, 2, 0, 0, 2
"c:\vs code\GitHub\internship\Center National des Innovations Pédagogiques et d'Expérimentation (CNIPE)\2024\dev\front-end\css\espaceFormation.css", "CSS", 0, 0, 20, -1, 7, 26
"c:\vs code\GitHub\internship\Center National des Innovations Pédagogiques et d'Expérimentation (CNIPE)\2024\dev\front-end\css\formation.css", "CSS", 0, 0, 15, 0, 2, 17
"c:\vs code\GitHub\internship\Center National des Innovations Pédagogiques et d'Expérimentation (CNIPE)\2024\dev\front-end\css\index.css", "CSS", 0, 0, 41, 0, 19, 60
"c:\vs code\GitHub\internship\Center National des Innovations Pédagogiques et d'Expérimentation (CNIPE)\2024\dev\front-end\css\manageAdmins.css", "CSS", 0, 0, 186, 0, 42, 228
"c:\vs code\GitHub\internship\Center National des Innovations Pédagogiques et d'Expérimentation (CNIPE)\2024\dev\front-end\css\profile.css", "CSS", 0, 0, 449, 0, 137, 586
"c:\vs code\GitHub\internship\Center National des Innovations Pédagogiques et d'Expérimentation (CNIPE)\2024\dev\front-end\css\style.css", "CSS", 0, 0, 25, 4, 18, 47
"c:\vs code\GitHub\internship\Center National des Innovations Pédagogiques et d'Expérimentation (CNIPE)\2024\dev\front-end\formation.html", "HTML", -14, 0, 0, -1, -4, -19
"c:\vs code\GitHub\internship\Center National des Innovations Pédagogiques et d'Expérimentation (CNIPE)\2024\dev\front-end\index.html", "HTML", 14, 0, 0, 0, 3, 17
"c:\vs code\GitHub\internship\Center National des Innovations Pédagogiques et d'Expérimentation (CNIPE)\2024\dev\front-end\js\course.js", "JavaScript", 0, 2, 0, 0, 2, 4
"c:\vs code\GitHub\internship\Center National des Innovations Pédagogiques et d'Expérimentation (CNIPE)\2024\dev\front-end\js\courseContent\clsManageCourseContent.js", "JavaScript", 0, 9, 0, 0, -2, 7
"c:\vs code\GitHub\internship\Center National des Innovations Pédagogiques et d'Expérimentation (CNIPE)\2024\dev\front-end\js\courseContent\clsManageCourseContentClasses\clsManageCourseContentAddDelete.js", "JavaScript", 0, 0, 0, -11, 0, -11
"c:\vs code\GitHub\internship\Center National des Innovations Pédagogiques et d'Expérimentation (CNIPE)\2024\dev\front-end\js\courseContent\clsManageCourseContentClasses\clsManageCourseContentComments.js", "JavaScript", 0, 699, 0, 20, 100, 819
"c:\vs code\GitHub\internship\Center National des Innovations Pédagogiques et d'Expérimentation (CNIPE)\2024\dev\front-end\js\courseContent\clsManageCourseContentClasses\clsManageCourseContentResources.js", "JavaScript", 0, 161, 0, 2, 25, 188
"c:\vs code\GitHub\internship\Center National des Innovations Pédagogiques et d'Expérimentation (CNIPE)\2024\dev\front-end\js\courseContent\clsManageCourseContentClasses\clsManageCourseContentReviews.js", "JavaScript", 0, 248, 0, 9, 48, 305
"c:\vs code\GitHub\internship\Center National des Innovations Pédagogiques et d'Expérimentation (CNIPE)\2024\dev\front-end\js\courseContent\clsManageCourseContentClasses\clsManageCourseContentSwitch.js", "JavaScript", 0, 9, 0, 0, 17, 26
"c:\vs code\GitHub\internship\Center National des Innovations Pédagogiques et d'Expérimentation (CNIPE)\2024\dev\front-end\js\courseContent\clsManageCourseContentClasses\clsManageRenderCourseContent.js", "JavaScript", 0, 8, 0, 0, 0, 8
"c:\vs code\GitHub\internship\Center National des Innovations Pédagogiques et d'Expérimentation (CNIPE)\2024\dev\front-end\js\courseContent\courseContent.js", "JavaScript", 0, 40, 0, 1, 7, 48
"c:\vs code\GitHub\internship\Center National des Innovations Pédagogiques et d'Expérimentation (CNIPE)\2024\dev\front-end\js\courseContent\courseContentDomVariables.js", "JavaScript", 0, 0, 0, 0, 1, 1
"c:\vs code\GitHub\internship\Center National des Innovations Pédagogiques et d'Expérimentation (CNIPE)\2024\dev\front-end\js\espaceFormation.js", "JavaScript", 0, 1, 0, 0, -1, 0
"c:\vs code\GitHub\internship\Center National des Innovations Pédagogiques et d'Expérimentation (CNIPE)\2024\dev\front-end\js\formation.js", "JavaScript", 0, 4, 0, 0, -4, 0
"c:\vs code\GitHub\internship\Center National des Innovations Pédagogiques et d'Expérimentation (CNIPE)\2024\dev\front-end\js\manageAdmins.js", "JavaScript", 0, 444, 0, 9, 71, 524
"c:\vs code\GitHub\internship\Center National des Innovations Pédagogiques et d'Expérimentation (CNIPE)\2024\dev\front-end\js\profile.js", "JavaScript", 0, 269, 0, 6, 48, 323
"c:\vs code\GitHub\internship\Center National des Innovations Pédagogiques et d'Expérimentation (CNIPE)\2024\dev\front-end\js\script.js", "JavaScript", 0, 65, 0, -6, 9, 68
"c:\vs code\GitHub\internship\Center National des Innovations Pédagogiques et d'Expérimentation (CNIPE)\2024\dev\front-end\manageAdmins.html", "HTML", 152, 0, 0, 6, 17, 175
"c:\vs code\GitHub\internship\Center National des Innovations Pédagogiques et d'Expérimentation (CNIPE)\2024\dev\front-end\profile.html", "HTML", 197, 0, 0, 4, 15, 216
"Total", "-", 226, 1959, 1019, -84, 712, 3832