"filename", "language", "HTML", "JavaScript", "XML", "CSS", "comment", "blank", "total"
"c:\vs code\GitHub\internship\Center National des Innovations Pédagogiques et d'Expérimentation (CNIPE)\2024\dev\front-end\EspaceFormation.html", "HTML", 157, 0, 0, 0, 6, 23, 186
"c:\vs code\GitHub\internship\Center National des Innovations Pédagogiques et d'Expérimentation (CNIPE)\2024\dev\front-end\aide.html", "HTML", 174, 0, 0, 0, 6, 21, 201
"c:\vs code\GitHub\internship\Center National des Innovations Pédagogiques et d'Expérimentation (CNIPE)\2024\dev\front-end\course.html", "HTML", 120, 0, 0, 0, 3, 17, 140
"c:\vs code\GitHub\internship\Center National des Innovations Pédagogiques et d'Expérimentation (CNIPE)\2024\dev\front-end\courseContent.html", "HTML", 392, 0, 0, 0, 12, 45, 449
"c:\vs code\GitHub\internship\Center National des Innovations Pédagogiques et d'Expérimentation (CNIPE)\2024\dev\front-end\css\aide.css", "CSS", 0, 0, 0, 286, 11, 86, 383
"c:\vs code\GitHub\internship\Center National des Innovations Pédagogiques et d'Expérimentation (CNIPE)\2024\dev\front-end\css\course.css", "CSS", 0, 0, 0, 220, 3, 112, 335
"c:\vs code\GitHub\internship\Center National des Innovations Pédagogiques et d'Expérimentation (CNIPE)\2024\dev\front-end\css\courseContent.css", "CSS", 0, 0, 0, 1261, 7, 575, 1843
"c:\vs code\GitHub\internship\Center National des Innovations Pédagogiques et d'Expérimentation (CNIPE)\2024\dev\front-end\css\domain.css", "CSS", 0, 0, 0, 353, 5, 139, 497
"c:\vs code\GitHub\internship\Center National des Innovations Pédagogiques et d'Expérimentation (CNIPE)\2024\dev\front-end\css\espaceFormation.css", "CSS", 0, 0, 0, 138, 5, 49, 192
"c:\vs code\GitHub\internship\Center National des Innovations Pédagogiques et d'Expérimentation (CNIPE)\2024\dev\front-end\css\formation.css", "CSS", 0, 0, 0, 152, 0, 37, 189
"c:\vs code\GitHub\internship\Center National des Innovations Pédagogiques et d'Expérimentation (CNIPE)\2024\dev\front-end\css\index.css", "CSS", 0, 0, 0, 236, 2, 78, 316
"c:\vs code\GitHub\internship\Center National des Innovations Pédagogiques et d'Expérimentation (CNIPE)\2024\dev\front-end\css\login.css", "CSS", 0, 0, 0, 6, 0, 2, 8
"c:\vs code\GitHub\internship\Center National des Innovations Pédagogiques et d'Expérimentation (CNIPE)\2024\dev\front-end\css\manageAdmins.css", "CSS", 0, 0, 0, 186, 0, 42, 228
"c:\vs code\GitHub\internship\Center National des Innovations Pédagogiques et d'Expérimentation (CNIPE)\2024\dev\front-end\css\profile.css", "CSS", 0, 0, 0, 449, 0, 137, 586
"c:\vs code\GitHub\internship\Center National des Innovations Pédagogiques et d'Expérimentation (CNIPE)\2024\dev\front-end\css\register.css", "CSS", 0, 0, 0, 17, 1, 4, 22
"c:\vs code\GitHub\internship\Center National des Innovations Pédagogiques et d'Expérimentation (CNIPE)\2024\dev\front-end\css\style.css", "CSS", 0, 0, 0, 579, 16, 194, 789
"c:\vs code\GitHub\internship\Center National des Innovations Pédagogiques et d'Expérimentation (CNIPE)\2024\dev\front-end\formation.html", "HTML", 140, 0, 0, 0, 5, 19, 164
"c:\vs code\GitHub\internship\Center National des Innovations Pédagogiques et d'Expérimentation (CNIPE)\2024\dev\front-end\imgs\addPost.svg", "XML", 0, 0, 7, 0, 0, 1, 8
"c:\vs code\GitHub\internship\Center National des Innovations Pédagogiques et d'Expérimentation (CNIPE)\2024\dev\front-end\index.html", "HTML", 148, 0, 0, 0, 4, 17, 169
"c:\vs code\GitHub\internship\Center National des Innovations Pédagogiques et d'Expérimentation (CNIPE)\2024\dev\front-end\js\course.js", "JavaScript", 0, 181, 0, 0, 3, 39, 223
"c:\vs code\GitHub\internship\Center National des Innovations Pédagogiques et d'Expérimentation (CNIPE)\2024\dev\front-end\js\courseContent\clsManageCourseContent.js", "JavaScript", 0, 56, 0, 0, 0, 11, 67
"c:\vs code\GitHub\internship\Center National des Innovations Pédagogiques et d'Expérimentation (CNIPE)\2024\dev\front-end\js\courseContent\clsManageCourseContentClasses\clsManageCourseContentAddDelete.js", "JavaScript", 0, 246, 0, 0, 11, 54, 311
"c:\vs code\GitHub\internship\Center National des Innovations Pédagogiques et d'Expérimentation (CNIPE)\2024\dev\front-end\js\courseContent\clsManageCourseContentClasses\clsManageCourseContentComments.js", "JavaScript", 0, 699, 0, 0, 20, 100, 819
"c:\vs code\GitHub\internship\Center National des Innovations Pédagogiques et d'Expérimentation (CNIPE)\2024\dev\front-end\js\courseContent\clsManageCourseContentClasses\clsManageCourseContentEdit.js", "JavaScript", 0, 235, 0, 0, 8, 58, 301
"c:\vs code\GitHub\internship\Center National des Innovations Pédagogiques et d'Expérimentation (CNIPE)\2024\dev\front-end\js\courseContent\clsManageCourseContentClasses\clsManageCourseContentResources.js", "JavaScript", 0, 161, 0, 0, 2, 25, 188
"c:\vs code\GitHub\internship\Center National des Innovations Pédagogiques et d'Expérimentation (CNIPE)\2024\dev\front-end\js\courseContent\clsManageCourseContentClasses\clsManageCourseContentReviews.js", "JavaScript", 0, 248, 0, 0, 9, 48, 305
"c:\vs code\GitHub\internship\Center National des Innovations Pédagogiques et d'Expérimentation (CNIPE)\2024\dev\front-end\js\courseContent\clsManageCourseContentClasses\clsManageCourseContentSwitch.js", "JavaScript", 0, 184, 0, 0, 5, 49, 238
"c:\vs code\GitHub\internship\Center National des Innovations Pédagogiques et d'Expérimentation (CNIPE)\2024\dev\front-end\js\courseContent\clsManageCourseContentClasses\clsManageRenderCourseContent.js", "JavaScript", 0, 138, 0, 0, 1, 23, 162
"c:\vs code\GitHub\internship\Center National des Innovations Pédagogiques et d'Expérimentation (CNIPE)\2024\dev\front-end\js\courseContent\clsManageSideBarAndOptions.js", "JavaScript", 0, 149, 0, 0, 3, 29, 181
"c:\vs code\GitHub\internship\Center National des Innovations Pédagogiques et d'Expérimentation (CNIPE)\2024\dev\front-end\js\courseContent\courseContent.js", "JavaScript", 0, 59, 0, 0, 1, 14, 74
"c:\vs code\GitHub\internship\Center National des Innovations Pédagogiques et d'Expérimentation (CNIPE)\2024\dev\front-end\js\courseContent\courseContentDomVariables.js", "JavaScript", 0, 1, 0, 0, 0, 1, 2
"c:\vs code\GitHub\internship\Center National des Innovations Pédagogiques et d'Expérimentation (CNIPE)\2024\dev\front-end\js\domain.js", "JavaScript", 0, 52, 0, 0, 0, 7, 59
"c:\vs code\GitHub\internship\Center National des Innovations Pédagogiques et d'Expérimentation (CNIPE)\2024\dev\front-end\js\espaceFormation.js", "JavaScript", 0, 413, 0, 0, 8, 85, 506
"c:\vs code\GitHub\internship\Center National des Innovations Pédagogiques et d'Expérimentation (CNIPE)\2024\dev\front-end\js\formation.js", "JavaScript", 0, 645, 0, 0, 11, 140, 796
"c:\vs code\GitHub\internship\Center National des Innovations Pédagogiques et d'Expérimentation (CNIPE)\2024\dev\front-end\js\index.js", "JavaScript", 0, 23, 0, 0, 2, 8, 33
"c:\vs code\GitHub\internship\Center National des Innovations Pédagogiques et d'Expérimentation (CNIPE)\2024\dev\front-end\js\login.js", "JavaScript", 0, 59, 0, 0, 5, 21, 85
"c:\vs code\GitHub\internship\Center National des Innovations Pédagogiques et d'Expérimentation (CNIPE)\2024\dev\front-end\js\manageAdmins.js", "JavaScript", 0, 444, 0, 0, 9, 71, 524
"c:\vs code\GitHub\internship\Center National des Innovations Pédagogiques et d'Expérimentation (CNIPE)\2024\dev\front-end\js\profile.js", "JavaScript", 0, 269, 0, 0, 6, 48, 323
"c:\vs code\GitHub\internship\Center National des Innovations Pédagogiques et d'Expérimentation (CNIPE)\2024\dev\front-end\js\register.js", "JavaScript", 0, 106, 0, 0, 6, 22, 134
"c:\vs code\GitHub\internship\Center National des Innovations Pédagogiques et d'Expérimentation (CNIPE)\2024\dev\front-end\js\script.js", "JavaScript", 0, 426, 0, 0, 16, 67, 509
"c:\vs code\GitHub\internship\Center National des Innovations Pédagogiques et d'Expérimentation (CNIPE)\2024\dev\front-end\login.html", "HTML", 37, 0, 0, 0, 2, 7, 46
"c:\vs code\GitHub\internship\Center National des Innovations Pédagogiques et d'Expérimentation (CNIPE)\2024\dev\front-end\manageAdmins.html", "HTML", 152, 0, 0, 0, 6, 17, 175
"c:\vs code\GitHub\internship\Center National des Innovations Pédagogiques et d'Expérimentation (CNIPE)\2024\dev\front-end\profile.html", "HTML", 197, 0, 0, 0, 4, 15, 216
"c:\vs code\GitHub\internship\Center National des Innovations Pédagogiques et d'Expérimentation (CNIPE)\2024\dev\front-end\register.html", "HTML", 58, 0, 0, 0, 2, 8, 68
"Total", "-", 1575, 4794, 7, 3883, 226, 2565, 13050