"filename", "language", "HTML", "JavaScript", "CSS", "Python", "comment", "blank", "total"
"c:\vs code\GitHub\internship\Center National des Innovations Pédagogiques et d'Expérimentation (CNIPE)\2024\dev\back-end\app\models\user.py", "Python", 0, 0, 0, 2, 0, 0, 2
"c:\vs code\GitHub\internship\Center National des Innovations Pédagogiques et d'Expérimentation (CNIPE)\2024\dev\back-end\app\routes.py", "Python", 0, 0, 0, 55, 9, 15, 79
"c:\vs code\GitHub\internship\Center National des Innovations Pédagogiques et d'Expérimentation (CNIPE)\2024\dev\front-end\EspaceFormation.html", "HTML", 9, 0, 0, 0, -23, 4, -10
"c:\vs code\GitHub\internship\Center National des Innovations Pédagogiques et d'Expérimentation (CNIPE)\2024\dev\front-end\aide.html", "HTML", 8, 0, 0, 0, -1, -2, 5
"c:\vs code\GitHub\internship\Center National des Innovations Pédagogiques et d'Expérimentation (CNIPE)\2024\dev\front-end\course.html", "HTML", -101, 0, 0, 0, 0, 5, -96
"c:\vs code\GitHub\internship\Center National des Innovations Pédagogiques et d'Expérimentation (CNIPE)\2024\dev\front-end\courseContent.html", "HTML", -189, 0, 0, 0, -72, -10, -271
"c:\vs code\GitHub\internship\Center National des Innovations Pédagogiques et d'Expérimentation (CNIPE)\2024\dev\front-end\css\course.css", "CSS", 0, 0, 6, 0, 0, 3, 9
"c:\vs code\GitHub\internship\Center National des Innovations Pédagogiques et d'Expérimentation (CNIPE)\2024\dev\front-end\css\courseContent.css", "CSS", 0, 0, 3, 0, 0, 2, 5
"c:\vs code\GitHub\internship\Center National des Innovations Pédagogiques et d'Expérimentation (CNIPE)\2024\dev\front-end\css\domain.css", "CSS", 0, 0, 1, 0, 0, 0, 1
"c:\vs code\GitHub\internship\Center National des Innovations Pédagogiques et d'Expérimentation (CNIPE)\2024\dev\front-end\css\espaceFormation.css", "CSS", 0, 0, 20, 0, -1, 7, 26
"c:\vs code\GitHub\internship\Center National des Innovations Pédagogiques et d'Expérimentation (CNIPE)\2024\dev\front-end\css\formation.css", "CSS", 0, 0, 16, 0, 0, 2, 18
"c:\vs code\GitHub\internship\Center National des Innovations Pédagogiques et d'Expérimentation (CNIPE)\2024\dev\front-end\css\index.css", "CSS", 0, 0, 41, 0, 0, 18, 59
"c:\vs code\GitHub\internship\Center National des Innovations Pédagogiques et d'Expérimentation (CNIPE)\2024\dev\front-end\css\manageAdmins.css", "CSS", 0, 0, 186, 0, 0, 41, 227
"c:\vs code\GitHub\internship\Center National des Innovations Pédagogiques et d'Expérimentation (CNIPE)\2024\dev\front-end\css\style.css", "CSS", 0, 0, 15, 0, 4, 16, 35
"c:\vs code\GitHub\internship\Center National des Innovations Pédagogiques et d'Expérimentation (CNIPE)\2024\dev\front-end\formation.html", "HTML", -13, 0, 0, 0, -1, -5, -19
"c:\vs code\GitHub\internship\Center National des Innovations Pédagogiques et d'Expérimentation (CNIPE)\2024\dev\front-end\index.html", "HTML", 11, 0, 0, 0, 0, 5, 16
"c:\vs code\GitHub\internship\Center National des Innovations Pédagogiques et d'Expérimentation (CNIPE)\2024\dev\front-end\js\course.js", "JavaScript", 0, 4, 0, 0, 0, 1, 5
"c:\vs code\GitHub\internship\Center National des Innovations Pédagogiques et d'Expérimentation (CNIPE)\2024\dev\front-end\js\courseContent\clsManageCourseContentClasses\clsManageCourseContentComments.js", "JavaScript", 0, 3, 0, 0, 0, 1, 4
"c:\vs code\GitHub\internship\Center National des Innovations Pédagogiques et d'Expérimentation (CNIPE)\2024\dev\front-end\js\courseContent\clsManageCourseContentClasses\clsManageCourseContentReviews.js", "JavaScript", 0, -1, 0, 0, 0, -1, -2
"c:\vs code\GitHub\internship\Center National des Innovations Pédagogiques et d'Expérimentation (CNIPE)\2024\dev\front-end\js\courseContent\courseContent.js", "JavaScript", 0, 38, 0, 0, 1, 3, 42
"c:\vs code\GitHub\internship\Center National des Innovations Pédagogiques et d'Expérimentation (CNIPE)\2024\dev\front-end\js\espaceFormation.js", "JavaScript", 0, 1, 0, 0, 0, -1, 0
"c:\vs code\GitHub\internship\Center National des Innovations Pédagogiques et d'Expérimentation (CNIPE)\2024\dev\front-end\js\formation.js", "JavaScript", 0, 8, 0, 0, 0, 1, 9
"c:\vs code\GitHub\internship\Center National des Innovations Pédagogiques et d'Expérimentation (CNIPE)\2024\dev\front-end\js\manageAdmins.js", "JavaScript", 0, 444, 0, 0, 9, 70, 523
"c:\vs code\GitHub\internship\Center National des Innovations Pédagogiques et d'Expérimentation (CNIPE)\2024\dev\front-end\js\profile.js", "JavaScript", 0, 1, 0, 0, 0, -17, -16
"c:\vs code\GitHub\internship\Center National des Innovations Pédagogiques et d'Expérimentation (CNIPE)\2024\dev\front-end\js\script.js", "JavaScript", 0, 14, 0, 0, -10, 1, 5
"c:\vs code\GitHub\internship\Center National des Innovations Pédagogiques et d'Expérimentation (CNIPE)\2024\dev\front-end\manageAdmins.html", "HTML", 78, 0, 0, 0, 3, 4, 85
"c:\vs code\GitHub\internship\Center National des Innovations Pédagogiques et d'Expérimentation (CNIPE)\2024\dev\front-end\profile.html", "HTML", 8, 0, 0, 0, 1, 4, 13
"Total", "-", -189, 512, 288, 57, -81, 167, 754